维权律师	“维权”律师
维权人士	“维权”人士
民运人士	“民运”分子 
法轮功	“法轮功”
疆独	“疆独”
藏独	“藏独”
六四	“六四”
江派	“江派”
团派	“团派”
太子党	“太子党”
十三五	“十三五”
“十八大”	十八大
“十九大”	十九大
习马会	“习马会”
首虎	“首虎”
打虎	“打虎”
大老虎	“大老虎”
港独	“港独”
警政署	“警政署”
陆委会	“陆委会”
民代	“民代”
民意代表	“民意代表”
民运	“民运”
台独	“台独”
文革	“文革”
中国民主党	“中国民主党”
中央通讯社	“中央社”
中央日报	《中央日报》
不发拨通	无法拨通
一带一路	“一带一路”
